( ( net
( "VSS!" "vss!" )
( "A" "a" )
( "ZN" "zn" )
( "VDD!" "vdd!" )
 )
( inst
( "M_i_0_0_x4_2" "m_i_0_0_x4_2" )
( "M_i_1_0_x4_2" "m_i_1_0_x4_2" )
( "M_i_0_0_x4_0" "m_i_0_0_x4_0" )
( "M_i_0_0_x4_1" "m_i_0_0_x4_1" )
( "M_i_1_0_x4_3" "m_i_1_0_x4_3" )
( "M_i_1_0_x4_0" "m_i_1_0_x4_0" )
( "M_i_0_0_x4_3" "m_i_0_0_x4_3" )
( "M_i_1_0_x4_1" "m_i_1_0_x4_1" )
 )
 )
